page=Page
popup=Popup
basic=Basic
chart=Chart
text=Text
beeline=Beeline
rectangle=Rectangle 
circle=Cirlce
menulist=Menu     
button=Button
table=Table
image=Image    
light=Light     
pipeline1=Pipeline one
pipeline2=Pipeline two
pipeline3=Pipeline three 
progress=Progress  
link=Link    
lineChart=Line chart
gaugeChart=Gauge chart
cancel=Cancel
save=Save
saveApply=Save application
defaultMenu=Navigation
menuPosition=Position
menuStyle=Style
preview=Preview
savePreviewApply=Save and preview this application
noData=No data
loading=loading...
thisApply=This application
isEditing=is editing
canNotSave=can not save
rename=Rename
delete=Delete
copy=Copy
cut=Cut
paste=Paste
toFront=Top
toBack=Bottom
resetHide=Reset hide
resetVisible=Reset show
undo=Undo
redo=Redo
group=Group
ungroup=Ungroup
insertMenuBefore=Insert menu left
insertMenuAfter=Insert menu Right
deleteRow=Delete Row
deleteCol=Delete Column
addUpRow=Insert row up
addLowerRow=Insert row lower
addLeftCol=Insert column left
addRightCol=Insert column right
collectCustom=Add to widget library
selectPic=Select picture
sureDel=Sure to delete
keepAtLeastOne=Keep at least one
tips=Tips
confirm=Confirm
apply=Apply
nameCannotEmpty=Name can't emtpy
copyP=copy
defaultColor=Default color
recentlyUsed=Recently used
inputText=Input text
collapseExpand=Collapse/Expand
triangle=Triangle
pentagram=Pentagram
status=status
buttonSwitch=Button switch
