page=Page
popup=Popup
basic=Basic
chart=Chart
text=Text
beeline=Beeline
rectangle=Rectangle 
circle=Cirlce
menulist=Menulist      
button=Button
table=表格
image=图片    
light=灯     
pipeline1=管道1
pipeline2=管道2
pipeline3=管道3
progress=进度条  
link=链接    
lineChart=趋势图   
gaugeChart=仪表盘
cancel=取消
save=保存
saveApply=保存应用
defaultMenu=默认导航
menuPosition=导航位置
menuStyle=导航风格
preview=预览
savePreviewApply=保存应用
noData=暂无数据
loading=加载中...
thisApply=此应用
isEditing=编辑中
canNotSave=不能保存
copyPage=复制页面
copyPopup=复制弹窗
addTemplate=添加到模板
rename=重命名
delete=删除
setHome=设为首页
copy=复制
cut=剪切
paste=粘贴
toFront=置顶
toBack=置底
resetHide=设为隐藏
resetVisible=设为显示
undo=撤销
group=组合
ungroup=取消组合
insertMenuBefore=往前插入菜单
insertMenuAfter=往后插入菜单
deleteRow=删除行
deleteCol=删除列
addUpRow=上方插入行
addLowerRow=下方插入行
addLeftCol=左侧插入列
addRightCol=右侧插入列
selectPic=选择图片
notDragWidgetCanNotAddTemplate=画布中没有控件，不能添加模板
sureDel=确定删除
keepAtLeastOne=至少保留一个
tips=提示
confirm=确定
nameCannotEmpty=名次不能为空
nameCannotOver20Charts=不能超过20个字符
copyP=副本
